1,1,1,1,1,-3,-3,-3,1,1,1,1,1,1,1,1,1,1,1,1
1,0,0,0,0,0,0,0,0,0,0,0,0,0,0,0,0,0,0,1
1,0,0,0,0,0,0,0,3,3,3,3,3,0,0,0,0,0,0,1
1,0,0,3,0,4,0,0,1,1,1,1,1,0,0,0,0,0,0,1
1,0,0,3,0,0,0,0,0,0,0,0,0,0,0,0,0,0,5,1
1,0,0,3,0,0,0,0,0,0,0,0,0,0,0,0,1,1,1,1
-3,0,0,0,0,0,-1,0,0,0,0,0,0,0,0,0,0,0,0,-3
-3,0,0,0,1,1,1,1,1,1,1,0,0,0,0,0,0,0,0,-3
-3,0,0,0,0,0,0,0,0,0,0,0,0,0,4,0,0,0,0,-3
1,0,0,0,0,0,0,0,0,0,0,0,0,0,0,0,0,0,0,1
1,0,0,0,0,0,0,0,0,0,0,0,0,0,0,0,0,0,0,1
1,0,0,9,9,9,0,0,0,0,0,0,3,3,3,3,0,0,0,1
1,0,0,0,0,0,0,0,0,0,0,0,1,1,1,1,0,0,0,1
1,0,0,0,0,0,0,0,0,0,0,0,0,0,0,0,0,0,0,1
1,0,0,0,0,0,3,3,3,3,0,0,0,0,0,0,0,0,0,1
1,0,0,0,0,0,1,1,1,1,0,0,0,0,0,0,0,0,0,1
1,0,0,0,0,0,0,0,0,0,0,0,0,0,0,0,6,6,6,1
1,0,-2,0,0,0,0,0,0,0,0,0,0,0,-1,6,2,2,2,1
1,0,0,0,0,0,0,0,0,0,0,0,0,0,0,0,1,1,1,1
1,1,1,1,1,-3,-3,-3,1,1,1,1,1,1,1,1,1,1,1,1
